Date: Tue, 10 Dec 1996 22:14:06 GMT
Server: NCSA/1.4.2
Content-type: text/html
Last-modified: Mon, 12 Feb 1996 22:22:48 GMT
Content-length: 3952



favorites



books

Zoo Story - Edward Albee
  Bastard Out of Carolina - Dorothy Allison
  Trash - Dorothy Allison       
  Crime and Punishment - Fyodor Doestoevsky
  Thomas and Beulah - Rita Dove
  Absalom Absalom - William Faulkner
  Listen Up: Voices from the Next Feminist Generation - Barbara Findlen, editor
  The Bone People - Keri Hulme
  Corregidora - Gayl Jones
  Civil Wars - June Jordan
  At the Bottom of the River - Jamaica Kincaid
  Savage Inequalities - Jonathan Kozol
  Song of Solomon - Toni Morrison
  Sula - Toni Morrison
  Twenty Love Poems - Pablo Neruda
  Mindstorms: Children, Computers and Powerful Ideas - Seymour Papert
  Housekeeping - Marilynne Robinson
  For Colored Girls Who Have Considered Suicide When the Rainbow is Enuf - Ntozake Shange
  A Daughter's Geography - Ntozake Shange
  The Man Who Fell in Love with the Moon - Tom Spanbauer
  The Grapes of Wrath - John Steinbeck
  Of Mice and Men - John Steinbeck
  Sophie's Choice - William Styron


music

 Little Earthquakes - Tori Amos
 Home of the Brave - Laurie Anderson
 Strange Angels - Laurie Anderson
 Power of Pussy - Bongwater
   Hounds of Love - Kate Bush
 Peggy Suicide - Julian Cope
 Out of Range - Ani DiFranco
 Puddle Dive - Ani DiFranco
 Green Mind - Dinosaur Jr
 Sweet Dreams (Are Made of This) - The Eurthymics
   The Good Earth - The Feelies
   Time for a Witness - The Feelies
   One Fair Summer Evening - Nanci Griffith
 Ingenue - kd lang
   Diva - Annie Lennox 
 Pontiac - Lyle Lovett
 Good - Morphine
 Exile in Guyville - Liz Phair
 Doolittle - Pixies
 Murmur - REM
   Arkansas Traveler - Michelle Shocked
   Trashman Shoes - Shoulders
   Sun Tunnels - Texas Instruments
   Eden Alley - Timbuk 3
   2 Nice Girls - 2 Nice Girls
  Gish - Smashing Pumpkins
 Pisces Iscariot - Smashing Pumpkins
 The Sky is Crying - Stevie Ray Vaughan
 Rain Dogs - Tom Waits
 Lucinda Williams - Lucinda Williams

